1,1,1,1,1,1,1,1,1,1,1,1
1,s,0,0,0,0,0,1,1,1,1,1
1,1,1,1,1,1,0,1,1,1,1,1
1,1,1,1,1,1,0,1,1,1,1,1
1,1,1,1,1,1,0,1,1,1,1,1
1,1,1,1,1,1,0,0,0,0,0,1
1,1,1,1,1,1,0,0,0,0,0,1
1,1,1,1,1,1,0,0,e1,0,0,1
1,1,1,1,1,1,0,0,0,0,0,1
0,0,d1,0,0,0,0,0,0,0,0,1
1,1,1,0,1,1,1,1,1,1,1,1
1,0,0,0,0,0,0,1,h,0,0,1
1,0,0,0,0,e2,0,1,1,0,e4,1
1,0,0,0,0,0,0,1,0,0,0,1
1,f4,0,0,0,0,0,1,0,0,0,1
1,0,0,0,1,0,0,0,0,0,0,1
1,0,0,1,1,0,0,0,0,0,f2,1
1,0,0,k1,1,0,0,0,0,0,h,1
1,1,1,1,1,1,1,1,1,1,1,1
